ABBBBBBBBBBBBBBBBBBBBBBBBBBBBBBBBBBBBBBC
DEEEEEEEEEEEEEEEEEEEEEEEEEEEEEEEEEEEEEEF
DEEEEEEEEEEEEEEEEEEEEEEEEEEEEEEEEEEEEEEF
DEEEEEEEEEEEEEEEEEEEEEEEEEEEEEEEEEEEEEEF
DEEEEEEEEEEEEEEEEEEEEEEEEEEEEEEEEEEEEEEF
DEEEEEEEEEEEEEEEEEEEEEEEEEEEEEEEEEEEEEEF
DEEEEEEEEEEEEEEEEEEEEEEEEEEEEEEEEEEEEEEF
DEEEEEEEEEEEEEEEEEEEEEEEEEEEEEEEEEEEEEEF
DEEEEEEEEEEEEEEEEEEEEEEEEEEEEEEEEEEEEEEF
DEEEEEEEEEEEEEEEEEEEEEEEEEEEEEEEEEEEEEEF
DEEEEEEEEEEEEEEEEEEEEEEEEEEEEEEEEEEEEEEF
DEEEEEEEEEEEEEEEEEEEEEEEEEEEEEEEEEEEEEEF
DEEEEEEEEEEEEEEEEEEEEEEEEEEEEEEEEEEEEEEF
DEEEEEEEEEEEEEEEEEEEEEEEEEEEEEEEEEEEEEEF
DEEEEEEEEEEEEEEEEEEEEEEEEEEEEEEEEEEEEEEF
DEEEEEEEEEEEEEEEEEEEEEEEEEEEEEEEEEEEEEEF
DEEEEEEEEEEEEEEEEEEEEEEEEEEEEEEEEEEEEEEF
DEEEEEEEEEEEEEEEEEEEEEEEEEEEEEEEEEEEEEEF
DEEEEEEEEEEEEEEEEEEEEEEEEEEEEEEEEEEEEEEF
DEEEEEEEEEEEEEEEEEEEEEEEEEEEEEEEEEEEEEEF
DEEEEEEEEEEEEEEEEEEEEEEEEEEEEEEEEEEEEEEF
DEEEEEEEEEEEEEEEEEEEEEEEEEEEEEEEEEEEEEEF
DEEEEEEEEEEEEEEEEEEEEEEEEEEEEEEEEEEEEEEF
DEEEEEEEEEEEEEEEEEEEEEEEEEEEEEEEEEEEEEEF
DEEEEEEEEEEEEEEEEEEEEEEEEEEEEEEEEEEEEEEF
DEEEEEEEEEEEEEEEEEEEEEEEEEEEEEEEEEEEEEEF
DEEEEEEEEEEEEEEEEEEEEEEEEEEEEEEEEEEEEEEF
DEEEEEEEEEEEEEEEEEEEEEEEEEEEEEEEEEEEEEEF
DEEEEEEEEEEEEEEEEEEEEEEEEEEEEEEEEEEEEEEF
GHHHHHHHHHHHHHHHHHHHHHHHHHHHHHHHHHHHHHHI
