ABBBBBBBBBBBBBBBBBBBBBBBBBBBBBBBBBBBBBBA
CDDDDDDDDDDDDDDDDDDDDDDDDDDDDDDDDDDDDDDE
CDDDDDDDDDDDDDDDDDDDDDDDDDDDDDDDDDDDDDDE
CDDDDDDDDDDDDDDDDDDDDDDDDDDDDDDDDDDDDDDE
CDDDDDDDDDDDDDDDDDDDDDDDDDDDDDDDDDDDDDDE
CDDDDDDDDDDDDDDDDDDDDDDDDDDDDDDDDDDDDDDE
CDDDDDDDDDDDDDDDDDDDDDDDDDDDDDDDDDDDDDDE
CDDDDDDDDDDDDDDDDDDDDDDDDDDDDDDDDDDDDDDE
CDDDDDDDDDDDDDDDDDDDDDDDDDDDDDDDDDDDDDDE
CDDDDDDDDDDDDDDDDDDDDDDDDDDDDDDDDDDDDDDE
CDDDDDDDDDDDDDDDDDDDDDDDDDDDDDDDDDDDDDDE
CDDDDDDDDDDDDDDDDDDDDDDDDDDDDDDDDDDDDDDE
CDDDDDDDDDDDDDDDDDDDDDDDDDDDDDDDDDDDDDDE
CDDDDDDDDDDDDDDDDDDDDDDDDDDDDDDDDDDDDDDE
CDDDDDDDDDDDDDDDDDDDDDDDDDDDDDDDDDDDDDDE
CDDDDDDDDDDDDDDDDDDDDDDDDDDDDDDDDDDDDDDE
CDDDDDDDDDDDDDDDDDDDDDDDDDDDDDDDDDDDDDDE
CDDDDDDDDDDDDDDDDDDDDDDDDDDDDDDDDDDDDDDE
CDDDDDDDDDDDDDDDDDDDDDDDDDDDDDDDDDDDDDDE
CDDDDDDDDDDDDDDDDDDDDDDDDDDDDDDDDDDDDDDE
CDDDDDDDDDDDDDDDDDDDDDDDDDDDDDDDDDDDDDDE
CDDDDDDDDDDDDDDDDDDDDDDDDDDDDDDDDDDDDDDE
CDDDDDDDDDDDDDDDDDDDDDDDDDDDDDDDDDDDDDDE
CDDDDDDDDDDDDDDDDDDDDDDDDDDDDDDDDDDDDDDE
CDDDDDDDDDDDDDDDDDDDDDDDDDDDDDDDDDDDDDDE
CDDDDDDDDDDDDDDDDDDDDDDDDDDDDDDDDDDDDDDE
CDDDDDDDDDDDDDDDDDDDDDDDDDDDDDDDDDDDDDDE
CDDDDDDDDDDDDDDDDDDDDDDDDDDDDDDDDDDDDDDE
CDDDDDDDDDDDDDDDDDDDDDDDDDDDDDDDDDDDDDDE
FGGGGGGGGGGGGGGGGGGGGGGGGGGGGGGGGGGGGGGA
