ABBBBBBBBBBBBBBBBBBBBBBBBBBBBBBBBBBBBBBC
DEEEEEEEEEEEEEEEEEEEEEEEEEEEEEEEEEEEEEEF
DEEEEEEEEEEEEEEEEEEEEEEEEEEEEEEEEEEEEEEF
DEEEEEEEEEEEEEEEEEEEEEEEEEEEEEEEEEEEEEEF
DEEEEEEEE0111111111112EEEEEEEEEEEEEEEEEF
DEEEEEEEE3444444444445EEEEEEEEEEEEEEEEEF
DEEEEEEEE3444444444445EEEEEEEEEEEEEEEEEF
DEEEEEEEE6777777777778EEEEEEEEEEEEEEEEEF
DEEEEEEEEEEEEEEEEEEEEEEEEEEEEEEEEEEEEEEF
DEEEEEEEEEEEEEEEEEEEEEEEEEEEEEEEEEEEEEEF
DEEEEEEEEEEEEEEEEEEEEEEEEEEEEEEEEEEEEEEF
DEEEEEEEEEEEEEEEEEEEEEEEEEEEEEEEEEEEEEEF
DEEEEEEEEEEEEEEEEEEEEEEEEEEEEEEEEEEEEEEF
DEEEEEEEEEEEEEEEEEEEEEEEEEEEEEEEEEEEEEEF
DEEEEEEEEEEEEEEEEEEEEEEEEEEEEEEEEEEEEEEF
DBBBBBBBBBBBBWWBBBBBBBBBBBBtBBBBBBBBBBBF
DEEEEEEEEEEEEEEEEEEEEEEEEEEdEEEEEEEEEEEF
DEEEEEEEEEEEEEEEEEEEEEEEEEEdEEEEEEEEEEEF
DEEEEEEEKEEEEEEEEEEKEEEEEEEdEEEEEEEEEEEF
DEEEEEEEEEEEEEEEEEEEEEEEEEEdEEEEEEEEEEEF
DEEEEEEEEEEEEEEEEEEEEEEEEEEdEEEEEEEEEEEF
DBBBBBBBBBBBBBtBBBBBBUUBBBBlBBBBBooBBBBF
DEEEEEEEEEEEEEdEEEEEEEEEEEEEEEEEEEEEEEEF
DEEEEEEEEEEEEEdEEEEEEEEEEEEEEEEEEEEEEEEF
DEEEEEEEEEEEEEdEEEEEEEEEEEEEEEEEEEEEEEEF
DEEEEEEEEJEEEEvEEEEEJEEEEEEEEEEJEEEEEEEF
DEEEEEEEEEEEEEvEEEEEEEEEEEEEEEEEEEEEEEEF
DEEEEEEEEEEEEEdEEEEEEEEEEEEEEEEEEEEEEEEF
DEEEEEEEEEEEEEdEEEEEEEEEEEEEEEEEEEEEEEEF
GHHHHHHHHHHHHHlHHHHHHHHHHHHHHHHHHHHHHHHI