ABBBBBBBBBBBBBBBBBBBBBBBBBBBBBBBBBBBBBBC
DEEEEEEEEEEEEEEEEEEEEEEEEEEEEEEEEEEEEEEF
DEEEEEEEEEEEEEEEEEEEEEEEEEEEEEEEEEEEEEEF
DEEEEEEEEEEEEEEEEEEEEEEEEEEEEEEEEEEEEEEF
DEEEEEEEEEEEEEEEEEEEEEEEEEEEEEEEEEEEEEEF
DEEEEEEEEEEEEEEEEEEEEEEEEEEEEEEEEEEEEEEF
DEEEEEEEEEEEEEEEEEEEEEEEEEEEEEEEEEEEEEEF
DEEEEEEEEEEEEEEEEEEEEEEEEEEEEEEEEEEEEEEF
DEEEEEEEEEEEEEEEEEEEEEEEEEEEEEEEEEEEEEEF
DEEEEEEEEEEEEEEEEEEEEEEEEEEEEEEEEEEEEEEF
DEEEEEEEEEEEEEEEEEEEEEEEEEEEEEEEEEEEEEEF
DEEEEEEEEEEEEEEEEEEEEEEEEEEEEEEEEEEEEEEF
DEEEEEEEEEEEEEEEEEEEEEEEEEEEEEEEEEEEEEEF
DEEEEEEEEEEEEEEEEEEEEEEEEEEEEEEEEEEEEEEF
DEEEEEEEEEEEEEEEEEEEEEEEEEEEEEEEEEEEEEEF
DBBBBBBBBBBBBWWBBBBBBBBBBBBtBBBBBBBBBBBF
DEEEEEEEEEEEEEEEEEEEEEEEEEEdEEEEEEEEEEEF
DEEEEEEEEEEEEEEEEEEEEEEEEEEdEEEEEEEEEEEF
DEEEEEEEEEEEEEEEEEEEEEEEEEEdEEEEEEEEEEEF
DEEEEEEEEEEEEEEEEEEEEEEEEEEdEEEEEEEEEEEF
DEEEEEEEEEEEEEEEEEEEEEEEEEEdEEEEEEEEEEEF
DBBBBBBBBBBBBBtBBBBBBUUBBBBlBBBBBooBBBBF
DEEEEEEEEEEEEEdEEEEEEEEEEEEEEEEEEEEEEEEF
DEEEEEEEEEEEEEdEEEEEEEEEEEEEEEEEEEEEEEEF
DEEEEEEEEEEEEEdEEEEEEEEEEEEEEEEEEEEEEEEF
DEEEEEEEEEEEEEvEEEEEEEEEEEEEEEEEEEEEEEEF
DEEEEEEEEEEEEEvEEEEEEEEEEEEEEEEEEEEEEEEF
DEEEEEEEEEEEEEdEEEEEEEEEEEEEEEEEEEEEEEEF
DEEEEEEEEEEEEEdEEEEEEEEEEEEEEEEEEEEEEEEF
GHHHHHHHHHHHHHlHHHHHHHHHHHHHHHHHHHHHHHHI