ABBBBBBBBBBBBBBBBBBBBBBBBBBBBBBBBBBBBBBC
DEEEEEEEEEEEEEEEEEEEEEEEEEEEEEEEEEEEEEEF
DEEEEEEEEEEEEEEEEEEEEEEEEEEEEEEEEEEEEEEF
DEEEEEEEEEEEEEEEEEEEEEEEEEEEEEEEEEEEEEEF
DEEEEEE012EEEEEEEEEEEEEEEEEEEEEEEEEEEEEF
DEEEEEE345EEEEEEEEEEEEEEEEEEEEEEEEEEEEEF
DEEEEEE678EEEEEEEEEEEEEE012EEEEEEEEEEEEF
DEEEEEEEEEEEEEEEEEEEEEEE345EEEEEEEEEEEEF
DEEEEEEEEEEEEEEEEEEEEEEE678EEEEEEEEEEEEF
DEEEEEEEEEEEEEEEEEEEEEEEEEEEEEEEEEEEEEEF
DEEEEEEEEEEEEEEEEEEEEEEEEEEEEEEEEEEEEEEF
DEEEEEEEEEEEEEEEEEEEEEEEEEEEEEEEEEEEEEEF
DEEEEEEEEEEEEEEEEEEEEEEEEEEEEEEEEEEEEEEF
DEEEEEEEEEEEEEEEEEEEEEEEEEEEEEEEEEEEEEEF
DEEEEEEEEEEEEEEEEEEEEEEEEEEEEEEEEEEEEEEF
DEEEEEEEEEEEEEEEEEEEEEEEEEEEEEEEEEEEEEEF
DEEEEEEEEEEEEEEEEEEEEEEEEEEEEEEEEEEEEEEF
DEEEEEEEEEEEEEEEEEEEEEEEEEEEEEEEEEEEEEEF
DEEEEEEEEEEEEEEEEEEEEEEEEEEEEEEEEEEEEEEF
DEEEEEEEEEEEEEEEEEEEEEEEEEEEEEEEEEEEEEEF
DEEEEEEEEEEEEEEEEEEEEEEEEEEEEEEEEEEEEEEF
DEEEEEEEEEEEEEEEEEEEEEEEEEEEEEEEEEEEEEEF
DEEEEEEEEEEEEEEEEEEEEEEEEEEEEEEEEEEEEEEF
DEEEEEEEEEEEEEEEEEEEEEEEEEEEEEEEEEEEEEEF
DEEEEEEEEEEEEEEEEEEEEEEEEEEEEEEEEEEEEEEF
DEEEEEEEEEEEEEEEEEEEEEEEEEEEEEEEEEEEEEEF
DEEEEEEEEEEEEEEEEEEEEEEEEEEEEEEEEEEEEEEF
DEEEEEEEEEEEEEEEEEEEEEEEEEEEEEEEEEEEEEEF
DEEEEEEEEEEEEEEEEEEEEEEEEEEEEEEEEEEEEEEF
GHHHHHHHHHHHHHHHHHHHHHHHHHHHHHHHHHHHHHHI
