ABBBBBBBBBBBBBBBBBBBBBBBBBBBBBBBBBBBBBBC
DEEEEEEEEEEEEEEEEEDEEEEEEEEEEEEEEEEEEEEF
DEEEEEEEEEEEEEEEEEDEEEEEEEEEEEEEEEEEEEEF
DEEEEEEEEEEEEEEEEEDEEEEEEEEEEEEEEEEEEEEF
DEEEEEE012EEEEEEEEDEEEEEEEEEEEEEEEEEEEEF
DEEEEEE345EEEEEEEEDEEEEEEEEEEEEEEEEEEEEF
DEEEEEE678EEEEEEEEDEEEEE012EEEEEEEEEEEEF
DEEEEEEEEEEEEEEEEEVEEEEE345EEEEEEEEEEEEF
DEEEEEEEEEEEEEEEEEVEEEEE678EEEEEEEEEEEEF
DEEEEEEEEEEEEEEEEEDEEEEEEEEEEEEEEEEEEEEF
DEEEEEEEEEEEEEEEEEDEEEEEEEEEEEEEEEEEEEEF
DEEEEEEEEEEEEEEEEEDEEEEEEEEEEEEEEEEEEEEF
DEEEEEEEEEEEEEEEEEDEEEEEEEEEEEEEEEEEEEEF
DEEEEEEREEESEEETEEDEEEEEEEEEEEEEEEEEEEEF
DEEEEEEEEEEEEEEEEEDEEEEEEEEEEEEEEEEEEEEF
DBBBZZBBBBBBBBBBBBBBBBBBBBBXXBBBBBBBBBBF
DEEEEEEEEEEEEEEEEEDEEEEEEEEEEEEEEEEEEEEF
DEEEEEEEEEEEEEEEEEDEEEEEEEEEEEEEEEEEEEEF
DEEEEEEEEEEEEEEEEEDEEEEEEEEEEEEEEEEEEEEF
DEEEEEEEEEEEEEEEEEDEJEEEEEEEEEEEEEEEEEEF
DEEEEEEEEEEEEEEEEEDEEEEEEEKEEEEEEEEEEEEF
DEEEEEEEEEEEEEEEEEDEEEEEEEEEEEEEEEEEEEEF
DEEEEEEEEEEEEEEEEEDEEEEEEEEEEEEEEEEEEEEF
DEEEEEEEEEEEEEEEEEVEEEEEEEEEEEEEEEEEEEEF
DEEEEEEEEEEEEEEEEEVEEEEEEEEEEEEEEEEEEEEF
DEEEEELEMENEOEPEEEDEEEEEEEEEEEEEEEEEEEEF
DEEEEEEEEEEEEEEEEEDEEEEEEEEEEEEEEEEEEEEF
DEEEEEEEEEEEEEEEEEDEEEEEEEEEEEEEEEEEEEEF
DEEEEEEEEEEEEEEEEEDEEEEEEEEEEEEEEEEEEEEF
GHHHHHHHHHHHHHHHHHHHHHHHHHHHHHHHHHHHHHHI
