ABBBBBBBBBBBBBBBBBBBBBBBBBBBBBBBBBBBBBBA
CDDDDDDDDDDDDDDDDDDDDDDDDDDDDDDDDDDDDDDE
CDDDDDDDDDDDDDDDDDDDDDDDDDDDDDDDDDDDDDDE
CDDDDDDDDDDDDDDDDDDDDDDDDDDDDDDDDDDDDDDE
CDDDDDD012DDDDDDDDDDDDDDDDDDDDDDDDDDDDDE
CDDDDDD345DDDDDDDDDDDDDDDDDDDDDDDDDDDDDE
CDDDDDD678DDDDDDDDDDDDDD012DDDDDDDDDDDDE
CDDDDDDDDDDDDDDDDDDDDDDD345DDDDDDDDDDDDE
CDDDDDDDDDDDDDDDDDDDDDDD678DDDDDDDDDDDDE
CDDDDDDDDDDDDDDDDDDDDDDDDDDDDDDDDDDDDDDE
CDDDDDDDDDDDDDDDDDDDDDDDDDDDDDDDDDDDDDDE
CDDDDDDDDDDDDDDDDDDDDDDDDDDDDDDDDDDDDDDE
CDDDDDDDDDDDDDDDDDDDDDDDDDDDDDDDDDDDDDDE
CDDDDDDDDDDDDDDDDDDDDDDDDDDDDDDDDDDDDDDE
CDDDDDDDDDDDDDDDDDDDDDDDDDDDDDDDDDDDDDDE
CDDDDDDDDDDDDDDDDDDDDDDDDDDDDDDDDDDDDDDE
CDDDDDDDDDDDDDDDDDDDDDDDDDDDDDDDDDDDDDDE
CDDDDDDDDDDDDDDDDDDDDDDDDDDDDDDDDDDDDDDE
CDDDDDDDDDDDDDDDDDDDDDDDDDDDDDDDDDDDDDDE
CDDDDDDDDDDDDDDDDDDDDDDDDDDDDDDDDDDDDDDE
CDDDDDDDDDDDDDDDDDDDDDDDDDDDDDDDDDDDDDDE
CDDDDDDDDDDDDDDDDDDDDDDDDDDDDDDDDDDDDDDE
CDDDDDDDDDDDDDDDDDDDDDDDDDDDDDDDDDDDDDDE
CDDDDDDDDDDDDDDDDDDDDDDDDDDDDDDDDDDDDDDE
CDDDDDDDDDDDDDDDDDDDDDDDDDDDDDDDDDDDDDDE
CDDDDDDDDDDDDDDDDDDDDDDDDDDDDDDDDDDDDDDE
CDDDDDDDDDDDDDDDDDDDDDDDDDDDDDDDDDDDDDDE
CDDDDDDDDDDDDDDDDDDDDDDDDDDDDDDDDDDDDDDE
CDDDDDDDDDDDDDDDDDDDDDDDDDDDDDDDDDDDDDDE
FGGGGGGGGGGGGGGGGGGGGGGGGGGGGGGGGGGGGGGA
