ABBBBBBBBBBBBBBBBBBBBBBBBBBBBBBBBBBBBBBC
DEEEEEEEEEEEEEEEEEDEEEEEEEEEEEEEEEEEEEEF
DEEEEEEEEEEEEEEEEEDDDDDEEEEEEEEEEEEEEEEF
DEEEEEEEEEEEEEEEEEEEEEDEEEEEEEEEEEEEEEEF
DEEEEEE012EEEEEEEEEEEEDEEEEEEEEEEEEEEEEF
DEEEEEE345EEEEEEEEDDDDDEEEEEEEEEEEEEEEEF
DEEEEEE678EEEEEEEEDEEEEE012EEEEEEEEEEEEF
DEEEEEEEEEEEEEEEEEVEEEEE345EEEEEEEEEEEEF
DEEEEEEEEEEEEEEEEEVEEEEE678EEEEEEEEEEEEF
DEEEEEErEEEEEEEEEEDEEEEEEEEEEEEEEEEEEEEF
DEEEEEEEEEEEEEEEEEDEEEEEEEEEEEEEEEEEEEEF
DEEEEEEEEEEEEEEEEEDEEEEEEEEEEEEEEEEEEEEF
DEEBBBBBBEEEEEEEEEDEEEEEEEEEEEEEEEEEEEEF
DEEBEEEEBEESEEETEEDEEEEEEEEEEEEEEEEEEEEF
DEEBEEEEBEEEEEEEEEDEEEEEEEEEEEEEEEEEEEEF
DBBBZZBBBBBBBBBBBBBBBBBBBBBXXBBBBBBBBBBF
DEEEEEEEEEEEEEEEEEDEEEEEEEEEEEEEEEEEEEEF
DEEEEEEEEEEEEEEEEEDEEEEEEEEEEEEEEEEEEEEF
DEEEEEEEEEEEEEEEEEDEEEEEEEEEEEEEEEEEEEEF
DEEEEEEEEEEEEEEEEEDEJEEEEEEEEEEEEEEEEEEF
DEEEEEEEEEEEEEEEEEDEEEEEEEKEEEEEEEEEEEEF
DEEEEEEEEEEEEEEEEEDEEEEEEEEEEEEEEEEEEEEF
DEEEEEEEEEEEEEEEEEDEEEEEEEEEEEEEEEEEEEEF
DEEEEEEEEEEEEEEEEEVEEEEEEEEEEEEEEEEEEEEF
DEEEEEEEEEEEEEEEEEVEEEEEEEEEEEEEEEEEEEEF
DEEEEELEMENEOEPEEEDEEEEEEEEEEEEEEEEEEEEF
DEEEEEEEEEEEEEEEEEDEEEEEEEEEEEEEEEEEEEEF
DEEEEEEEEEEEEEEEEEDEEEEEEEEEEEEEEEEEEEEF
DEEEEEEEEEEEEEEEEEDEEEEEEEEEEEEEEEEEEEEF
GHHHHHHHHHHHHHHHHHHHHHHHHHHHHHHHHHHHHHHI
