ABBBBBBBBBBBBBBBBBBBBBBBBBBBBBBBBBBBBBBC
DEEEEESSEEEEEEEEEEEEEEEEEEEOEEEEEEEEEEEF
DEEEE0111111111111111111111111111112EEEF
DEEEE3444444444444444444444444444445EEEF
DEEEE3444444444444444444444444444445EEEF
DEEEE3444444444444444444444444444445EEEF
DEEEE3444444444444444444444444444445EEEF
DEEEE3444444444444444444444444444445EEEF
DEEEE3444444444444444444444444444445EEEF
DEEEE3444444444444444444444444444445EEEF
DEEEE3444444444444444444444444444445EEEF
DEEEE3444444444444444444444444444445EEEF
DEEEE3444444444444444444444444444445EEEF
DEEEE6777777777777777777777777777778EEEF
DEEEEEEEEEEEEEEEEEEEEEEEEEEEEEEEEEEEEEEF
DBBBBBBBBBBBBWWBBBBBBBBBBBBtBBBBBBBBBBBF
DEEEEEEEEEEEEEEEEEEEEEEEEEEdEEEEEEEEEEEF
DEEEEEEEEEEEEEEEEEEEEEEEEEEdEEEEEEEEEEEF
DEEEEEEEKEEEEEEEEEEKEEEEEEEdEEEEEEEEEEEF
DEEEEEEEEEEEEEEEEEEEEEEEEEEdEEEEEEEEEEEF
DEEEEEEEEEEEEEEEEEEEEEEEEEEdEEEEEEEEEEEF
DBBBBBBBBBBBBBtBBBBBBUUBBBBlBBBBBooBBBBF
DEEEEEOEEEEEEEdEEEEEEEEEEEEESEEEEEEEEEEF
DEEEEEEEEEEEEEdEEEEEEEEEEEEEEEEEEEEEEEEF
DEEEEEEEEEEEEEdEEEEEEEEEEEEEEEEEEEEEEEEF
DEEEEEEEEJEEEEvEEEEEJEEEEEEEEEEJEEEEEEEF
DEEEEEEEEEEEEEvEEEEEEEEEEEEEEEEEEEEEEEEF
DEEEEEEEEEEEEEdEEEEEEEEEEEEEEEEEEEEEEEEF
DEEEEEEEEEEEEEdEEEEEEEEEEEEEEEEEEEEEEEEF
GHHHHHHHHHHHHHlHHHHHHHHHHHHHHHHHHHHHHHHI