ABBBBBBBBBBBBBBBBBBDBBBBBBBBBBBBBBBBBBBC
DEEEEEEEEEEEEEEEEEEDEEEEEEEEEEEEEEEEEEEF
DEEEEEEEEEEEEEEEEEEDEEEEEEEEEEEEEEEEEEEF
DEEEEEEEEEEEEEEEEEEDEEEEEEEEEEEEEEEEEEEF
DEEEEEEEEEEEEEEEEEEXEEEEEEEEEEEEEEEEEEEF
DEEEEEEEEEEEEEEEEEEXEEEEEEEEEEEEEEEEEEEF
DEEEEEEEEEEEEEEEEEEDEEEEEEEEEEEEEEEEEEEF
DEEEEEEEEEEEEEEEEEEDEEEEEEEEEEEEEEEEEEEF
DEEEEEEEEEEEEEEEEEEDEEEEEEEEEEEEEEEEEEEF
DBBBBUUBBBBBDBBWWBBDBBBBBBBBWWBBBBBBBBBF
DEEEEEEEEEEEDEEEEEEDEEEEEEEEEEEEEEEEEEEF
DEEEEEEEEEEEDEEEEEEDEEEEEEEEEEEEEEEEEEEF
DEEEEEEEEEEEDEEEEEEDEEEEEEEEEEEEEEEEEEEF
DEEEEEEEEEEEDEEEEEEDEEEEEEEEEEEEEEEEEEEF
DEEEEEEEEEEEDEEEEEEYEEEEEEEEEEEEEEEEEEEF
DEEEEEEEEEEEDEEEEEEYEEEEEEEEEEEEEEEEEEEF
DEEEEEEEEEEEYEEEEEEDEEEEEEEEEEEEEEEEEEEF
DEEEEEEEEEEEYEEEEEEDEEEEEEEEEEEEEEEEEEEF
DEEEEEEEEEEEDEEEEEEDEEEEEEEEEEEEEEEEEEEF
DBBBBBBBooBBDBBBBBBDBBBBBBBBBBBBBBBBBBBF
DEEEEEEEEEEEEEEEEEEEEEEEEEEEEEEEEEEEEEEF
DEEEEEEEEEEEEEEEEEEEEEEEEEEEEEEEEEEEEEEF
DEEEEEEEEEEEEEEEEEEEEEEEEEEEEEEEEEEEEEEF
DEEEEEEEEEEEEEEEEEEEEEEEEEEEEEEEEEEEEEEF
DEEEEEEEEEEEEEEEEEEEEEEEEEEEEEEEEEEEEEEF
DEEEEEEEEEEEEEEEEEEEEEEEEEEEEEEEEEEEEEEF
DEEEEEEEEEEEEEEEEEEEEEEEEEEEEEEEEEEEEEEF
DEEEEEEEEEEEEEEEEEEEEEEEEEEEEEEEEEEEEEEF
DEEEEEEEEEEEEEEEEEEEEEEEEEEEEEEEEEEEEEEF
GHHHHHHHHHHHHHHHHHHHHHHHHHHHHHHHHHHHHHHI
