ABBBBBBBBBBBBBBBBBBDBBBBBBBBBBBBBBBBBBBC
DEEEEEEEEEEEEEEEEEEDEEEEEEEEEEEEEEEEEEEF
DEEEEEEEEEEEEEEEEEEDEEEEEEEEEEEEEEEEEEEF
DEEEEEEEEEEEEEEEEEEDEEEEEEEEEEEEEEEEEEEF
DEEEEEEEEEEEEEEEEEEXEEEEEEEEEEEEEEEEEEEF
DEEEEEEEEEEEEEEEEEEXEEEEEEEEEEEEEEEEEEEF
DEEEEEEEEEEEEEEEEEEDEEEEEEEEEEEEEEEEEEEF
DEEEEEEEEEEEEEEEEEEDEEEEEEEEEEEEEEEEEEEF
DEEEEEEEEEEEEEEEEEEDEEEEEEEEEEEEEEEEEEEF
DBBBBUUBBBBBtBBWWBB+BBBBBBBBWWBBBBBBBBBF
DEEEEEEEEEEEDEEEEEEDEEEEEEEEEEEEEEEEEEEF
DEEEEEEEEEEEDEEEEEEDEEEEEEEEEEEEEEEEEEEF
DEEEEEEEEEEEDEEEEEEDEEEEEEEEEEEEEEEEEEEF
DEEEEEEEEEEEDEEEEEEDEEEEEEEEEEEEEEEEEEEF
DEEEEEEEEEEEDEEEEEEVEEEEEEEEEEEEEEEEEEEF
DEEEEEEEEEEEDEEEEEEVEEEEEEEEEEEEEEEEEEEF
DEEEEEEEEEEEVEEEEEEDEEEEEEEEEEEEEEEEEEEF
DEEEEEEEEEEEVEEEEEEDEEEEEEEEEEEEEEEEEEEF
DEEEEEEEEEEEDEEEEEEDEEEEEEEEEEEEEEEEEEEF
DBBBBBBBooBBlBBBBBBlBBBBBBBBBBBBBBBBBBBF
DEEEEEEEEEEEEEEEEEEEEEEEEEEEEEEEEEEEEEEF
DEEEEEEEEEEEEEEEEEEEEEEEEEEEEEEEEEEEEEEF
DEEEEEEEEEEEEEEEEEEEEEEEEEEEEEEEEEEEEEEF
DEEEEEEEEEEEEEEEEEEEEEEEEEEEEEEEEEEEEEEF
DEEEEEEEEEEEEEEEEEEEEEEEEEEEEEEEEEEEEEEF
DEEEEEEEEEEEEEEEEEEEEEEEEEEEEEEEEEEEEEEF
DEEEEEEEEEEEEEEEEEEEEEEEEEEEEEEEEEEEEEEF
DEEEEEEEEEEEEEEEEEEEEEEEEEEEEEEEEEEEEEEF
DEEEEEEEEEEEEEEEEEEEEEEEEEEEEEEEEEEEEEEF
GHHHHHHHHHHHHHHHHHHHHHHHHHHHHHHHHHHHHHHI
